1111111111111111111
1000000000P00000001
10000C000000000E001
1000000000000000001
1111111111111111111