1111111111111111111
1000000000P00000001
10000C0000000000001
1000000E00000000001
1111111111111111111