1111111111111111111
1CCCCCCCCCPCCCCCCC1
1CCCCCCCCCCCCCCECC1
1CCCCCCCCCCCCCCCCC1
1111111111111111111