1111111111
1P00C00011
100000M0E1
100000M001
100000M001
100000M001
100000M001
100000M001
1111111111