11111111111111111
1P00000CC1CCCCCC1
10111011110111101
1C001000100001001
1C111010111001001
1C101000100001001
10111010111001001
10000000000001001
10111111111001001
10000000000001001
10111011110111011
10001000100000001
11111011110111001
10CCC0000000000E1
11111111111111111