1111111111
10000010E1
1010101011
1P000C1001
1111111111