11111111111111111111111
1PCCC111C00C00C0000CCC1
1000010100000C000111111
10C00111001111111111111
1E000000000000000111111
1000C111111111111111101
10000C0C0C0C0C0C0111111
10000C000CC00CC0C111111
10000C0C0C0C0C0C0111111
10000C000CC00CC0C111111
10000C0C0C0C0C0C0111111
10000C000CC00CC0C111111
10000C0C0C0C0C0CC0C0C01
10000C000CC00CC000CC001
10000C0C0C0C0C0C0111111
10000C000CC00CC0C111111
11111111111111111111111