1111111111111
1E0000P0000C1
1111111111111